1 1 1 1 1 1 1 1 1 1 1 1 1 1 1 1 1 1 1 1 1 1 1 1 1 1 1 1 1 1 1 1 1 1 1 1 1 1 1 1 1 1 1 1 1 1 1 1 1 1 1 1 1 1 1 1 1 1 1 1 1 1 1 1 1 1 1 1 1 1 1 1
1 0 0 0 0 0 0 0 0 0 0 0 0 0 0 0 0 0 0 0 0 0 0 0 0 0 0 0 0 0 0 0 0 0 0 0 0 0 0 0 0 7 2 2 2 2 2 2 2 2 2 2 2 2 2 2 2 2 2 2 2 2 2 2 2 2 2 2 2 2 2 1
1 0 0 0 0 0 0 0 0 0 0 0 0 0 0 0 0 0 0 0 0 0 0 0 0 0 0 0 0 0 0 0 0 0 0 0 0 0 0 0 0 7 2 2 2 2 2 2 2 2 2 2 2 2 2 2 2 2 2 2 2 2 2 2 2 2 2 2 2 2 2 1
1 0 0 0 0 0 0 0 0 0 0 0 0 0 0 0 0 0 0 0 0 0 0 0 0 0 0 0 0 0 0 0 0 0 0 0 0 0 0 0 0 7 2 2 2 2 2 2 2 2 2 2 2 2 2 2 2 2 2 2 2 2 2 2 2 2 2 2 2 2 2 1
1 0 0 0 0 0 0 0 0 0 0 0 0 0 0 0 0 0 0 8 6 6 10 0 0 0 0 0 0 0 0 0 0 0 0 0 0 0 0 0 0 8 2 2 2 2 2 2 2 2 2 2 2 2 2 2 2 2 2 2 2 2 2 2 2 2 2 2 2 2 2 1
1 0 0 0 7 6 6 6 6 6 6 6 6 6 6 6 6 6 6 9 2 2 11 6 12 0 7 6 6 6 6 6 6 6 6 6 6 6 6 6 6 9 2 2 2 2 2 2 2 2 2 2 2 2 2 2 2 2 2 2 2 2 2 2 2 2 2 2 2 2 2 1
1 0 0 0 7 2 2 2 2 2 2 2 2 2 2 2 2 2 2 2 2 2 2 2 12 0 7 2 2 2 2 2 2 2 2 2 2 2 2 2 2 2 2 2 2 2 2 2 2 2 2 2 2 2 2 2 2 2 2 2 2 2 2 2 2 2 2 2 2 2 2 1
1 0 0 0 7 2 2 14 13 13 13 13 13 13 13 13 13 13 13 13 13 13 13 13 0 0 0 13 13 13 13 13 13 13 13 13 13 13 13 13 13 15 2 2 2 2 2 2 2 2 2 2 2 2 2 2 2 2 2 2 2 2 2 2 2 2 2 2 2 2 2 1
1 0 0 0 7 2 2 12 0 0 0 0 0 0 0 0 0 0 0 0 0 0 0 0 0 0 0 0 0 0 0 0 0 0 0 0 0 0 0 0 0 0 13 15 2 2 2 2 2 2 2 2 2 2 2 2 2 2 2 2 2 2 2 2 2 2 2 2 2 2 2 1
1 0 0 0 7 2 2 12 0 0 0 0 46 44 44 44 44 44 44 44 44 44 44 44 44 44 44 44 44 44 44 44 44 44 44 44 44 44 24 0 0 0 0 7 2 2 2 2 2 2 2 2 2 2 2 2 2 2 2 2 2 2 2 2 2 2 2 2 2 2 2 1
1 0 0 0 7 2 2 12 0 0 0 46 3 3 3 3 3 3 3 3 3 3 3 3 3 3 3 3 3 3 3 3 3 3 3 3 3 3 3 24 0 0 0 7 2 2 2 2 2 2 2 2 2 2 2 2 2 2 2 2 2 2 2 2 2 2 2 2 2 2 2 1
1 0 0 0 7 2 2 12 0 0 0 32 3 3 45 45 45 45 45 45 45 45 45 45 45 45 45 45 45 45 45 45 45 45 45 45 45 3 3 33 0 0 0 7 2 2 2 2 2 2 2 2 2 2 2 2 2 2 2 2 2 2 2 2 2 2 2 2 2 2 2 1
1 0 0 0 7 2 2 12 0 0 0 32 3 33 0 0 0 0 0 0 0 0 0 0 0 0 0 0 0 0 0 0 0 0 0 0 0 32 3 33 0 0 0 7 2 2 2 2 2 2 2 2 2 2 2 2 2 2 2 2 2 2 2 2 2 2 2 2 2 2 2 1
1 0 0 0 7 2 2 12 0 0 0 32 3 33 7 6 6 6 6 6 6 6 6 6 12 0 7 6 6 6 6 6 6 6 6 6 12 32 3 33 0 0 0 7 2 2 2 2 2 2 2 2 2 2 2 2 2 2 2 2 2 2 2 2 2 2 2 2 2 2 2 1
1 0 0 0 7 2 2 12 0 0 0 32 3 33 7 2 2 2 2 2 2 2 2 2 12 0 7 2 2 2 2 2 2 2 2 2 12 32 3 33 0 0 0 7 2 2 2 2 2 2 2 2 2 2 2 2 2 2 2 2 2 2 2 2 2 2 2 2 2 14 13 1
1 0 0 0 7 2 2 12 0 0 0 32 3 33 7 2 2 2 2 2 2 2 2 2 12 0 7 2 2 2 2 2 2 2 2 2 12 32 3 33 0 0 0 7 2 2 2 2 2 2 2 2 2 2 2 2 2 2 2 2 2 2 2 2 2 2 2 2 14 0 0 1
1 0 0 0 7 2 2 12 0 0 0 32 3 33 7 2 2 14 13 13 13 13 13 13 0 0 0 13 13 13 13 13 13 15 2 2 12 32 3 33 0 0 0 7 2 2 2 2 2 2 2 2 2 2 2 2 2 2 2 2 2 2 2 2 2 2 2 14 0 0 0 1
1 0 0 0 7 2 2 12 0 0 0 32 3 33 7 2 2 12 20 18 18 18 18 18 18 18 18 18 18 18 18 18 21 7 2 2 12 32 3 33 0 0 0 7 2 2 2 2 2 2 2 2 2 2 2 2 2 2 2 2 2 2 2 2 2 2 2 12 0 0 0 1
1 0 0 0 7 2 2 12 0 0 0 32 3 33 7 2 2 12 16 5 5 5 5 5 5 5 5 5 5 5 5 5 17 7 2 2 12 32 3 33 0 0 0 7 2 2 2 2 2 2 2 2 2 2 2 2 2 2 2 2 2 2 2 2 2 2 14 0 0 0 0 1
1 0 0 0 7 2 2 12 0 0 0 32 3 33 7 2 2 12 16 5 5 5 5 5 5 5 5 5 5 5 5 5 17 0 13 13 0 32 3 33 0 0 0 7 2 2 2 2 2 2 2 2 2 2 2 2 2 2 2 2 2 2 2 2 2 2 12 0 0 0 0 1
1 0 0 0 7 2 2 12 0 0 0 32 3 33 7 2 2 12 16 5 5 5 5 5 5 5 5 5 5 5 5 5 17 0 0 0 0 32 3 3 24 0 0 7 2 2 2 2 2 2 2 2 2 2 2 2 2 2 2 14 13 15 14 15 14 13 0 0 0 0 0 1
1 0 0 0 7 2 2 12 0 0 0 32 3 33 7 2 2 12 16 5 5 5 5 5 5 5 5 5 5 5 5 5 17 0 0 0 0 32 3 3 3 24 0 7 2 2 2 2 2 2 2 2 2 2 2 2 2 2 2 12 0 7 10 8 12 0 0 0 0 0 0 1
1 0 0 0 7 2 2 12 0 0 0 32 3 33 7 2 2 12 16 5 5 5 5 5 5 5 5 5 5 5 5 5 17 7 6 6 12 32 3 33 3 3 24 7 2 2 2 2 2 2 2 2 2 2 2 2 2 2 2 12 0 7 11 9 12 0 0 0 0 0 0 1
1 0 0 0 7 2 2 12 0 0 0 32 3 33 7 2 2 12 16 5 5 5 5 5 5 5 5 5 5 5 5 5 17 7 2 2 12 32 3 33 25 3 3 24 15 2 2 2 2 2 2 2 2 2 2 2 2 2 2 10 0 8 2 2 12 0 0 0 0 0 0 1
1 0 0 0 7 2 2 12 0 0 0 32 3 33 7 2 2 12 16 5 5 5 5 5 5 5 5 5 5 5 5 5 17 7 2 2 12 32 3 33 0 25 3 3 24 15 2 2 2 2 2 2 2 2 2 2 2 2 2 11 6 9 2 2 12 0 0 0 0 0 0 1
1 0 0 0 7 2 2 12 0 0 0 32 3 33 7 2 2 12 16 5 5 5 5 5 5 5 5 5 5 5 5 5 17 7 2 2 12 32 3 33 0 0 25 3 3 24 15 2 2 2 2 2 2 2 2 2 2 2 2 2 2 2 2 14 0 0 0 0 0 0 0 1
1 0 0 0 7 2 2 12 0 0 0 32 3 33 7 2 2 12 16 5 5 5 5 5 5 5 5 5 5 5 5 5 17 7 2 2 12 32 3 33 0 0 0 25 3 3 24 15 2 2 2 2 2 2 2 2 2 2 2 2 2 2 2 12 0 0 0 0 0 0 0 1
1 0 0 0 7 2 2 12 0 0 0 32 3 33 7 2 2 12 16 5 5 5 5 5 5 5 5 5 5 5 5 5 17 7 2 2 12 32 3 33 0 0 0 0 25 3 3 24 15 2 2 2 2 2 2 2 2 2 2 2 2 2 14 0 0 0 0 0 0 0 0 1
1 0 0 0 7 2 2 12 0 0 0 32 3 33 7 2 2 12 16 5 5 5 5 5 5 5 5 5 5 5 5 5 17 7 2 2 12 32 3 33 0 0 0 0 0 25 3 3 24 15 2 2 2 2 2 2 2 2 2 2 2 2 10 0 0 0 0 0 0 0 0 1
1 0 0 0 7 2 2 12 0 0 0 32 3 33 7 2 2 12 16 5 5 5 5 5 5 5 5 5 5 5 5 5 17 7 2 2 12 32 3 33 0 0 0 0 0 0 25 3 3 24 15 2 2 2 2 2 2 2 2 2 2 2 11 12 0 0 0 0 0 0 0 1
1 0 0 0 7 2 2 12 0 0 0 32 3 33 7 2 2 12 16 5 5 5 5 5 5 5 5 5 5 5 5 5 17 7 2 2 12 32 3 33 0 0 0 0 0 0 0 25 3 3 24 15 2 2 2 2 2 2 2 2 2 2 14 0 0 0 0 0 0 0 0 1
1 0 0 0 7 2 2 12 0 0 0 32 3 33 7 2 2 12 16 5 5 5 5 5 5 5 5 5 5 5 5 5 17 7 2 2 12 32 3 33 0 0 0 0 0 0 0 0 25 3 3 24 15 2 2 2 2 2 2 2 2 2 12 0 0 0 0 0 0 0 0 1
1 0 0 0 7 2 2 12 0 0 0 32 3 33 7 2 2 12 16 5 5 5 5 5 5 5 5 5 5 5 5 5 17 7 2 2 12 32 3 33 0 0 0 0 0 0 0 0 0 25 3 3 24 15 2 2 2 2 2 2 2 2 12 0 0 0 0 0 0 0 0 1
1 0 0 0 7 2 2 12 0 0 0 32 3 33 7 2 2 12 16 5 5 5 5 5 5 5 5 5 5 5 5 5 17 7 2 2 12 32 3 33 0 0 0 0 0 0 0 0 0 0 25 3 3 24 15 2 2 2 2 2 2 2 12 0 0 0 0 0 0 0 0 1
1 0 0 0 7 2 2 12 0 0 0 32 3 33 7 2 2 12 22 19 19 19 19 19 19 19 19 19 19 19 19 19 23 7 2 2 12 32 3 33 0 0 0 0 0 0 0 0 0 0 0 25 3 3 24 15 2 2 2 2 2 2 12 0 0 0 0 0 0 0 0 1
1 0 0 0 7 2 2 12 0 0 0 32 3 33 7 2 2 10 0 0 0 0 0 0 0 0 0 0 0 0 0 0 0 8 2 2 12 32 3 33 0 0 0 0 0 0 0 0 0 0 0 0 32 3 33 7 2 2 2 2 2 2 12 0 0 0 0 0 0 0 0 1
1 0 0 0 0 13 13 0 0 0 0 32 3 33 7 2 2 11 6 6 6 6 6 6 6 6 6 6 6 6 6 6 6 9 2 2 12 32 3 33 0 0 0 0 0 0 0 0 0 0 0 0 32 3 33 7 2 2 2 2 2 14 0 0 0 0 0 0 0 0 0 1
1 0 0 0 0 0 0 0 0 0 0 32 3 33 7 2 2 2 2 2 2 2 2 2 2 2 2 2 2 2 2 2 14 15 2 2 12 32 3 33 0 0 0 0 0 0 0 0 0 0 0 0 32 3 33 7 2 2 2 2 2 12 0 0 0 0 0 0 0 0 0 1
1 0 0 0 0 0 0 0 0 0 0 32 3 33 7 2 2 2 2 14 13 13 13 13 13 15 2 2 2 2 2 2 10 8 2 2 12 32 3 33 0 0 0 0 0 0 0 0 0 0 0 0 32 3 33 7 2 2 2 2 2 12 0 0 0 0 0 0 0 0 0 1
1 0 0 0 0 0 0 0 0 0 0 32 3 33 7 2 2 2 2 12 0 0 0 0 0 7 2 2 2 2 2 2 11 9 2 2 12 32 3 33 0 0 0 0 0 0 0 0 0 0 0 0 32 3 33 7 2 2 2 2 2 10 0 0 0 0 0 0 0 0 0 1
1 0 0 0 0 0 0 0 0 0 0 32 3 33 7 2 2 2 2 12 0 0 0 0 0 7 2 14 13 13 13 13 15 2 2 2 12 32 3 33 0 0 0 0 0 0 0 0 0 0 0 0 32 3 33 0 15 2 2 2 2 11 6 12 0 0 0 0 0 0 0 1
1 0 0 0 0 0 0 0 0 0 0 32 3 33 7 2 2 2 2 12 0 0 0 0 0 7 2 12 0 0 0 0 7 2 2 2 12 32 3 33 0 0 0 0 0 0 0 0 0 0 0 0 32 3 33 0 7 2 2 2 2 2 2 10 0 0 0 0 0 0 0 1
1 0 0 0 0 0 0 0 0 0 0 32 3 33 7 2 2 2 2 12 0 0 0 0 0 0 13 0 0 0 0 0 7 2 2 2 12 32 3 33 0 0 0 0 0 0 0 0 0 0 0 0 32 3 33 0 7 2 2 2 2 2 2 11 12 0 0 0 0 0 0 1
1 0 0 0 0 0 0 0 0 0 0 32 3 33 7 2 2 2 2 12 0 0 0 0 0 7 6 12 0 0 0 0 7 2 2 2 12 32 3 33 0 0 0 0 0 0 0 0 0 0 0 0 32 3 33 0 7 2 2 2 2 2 2 2 12 0 0 0 0 0 0 1
1 0 0 0 0 0 0 0 0 0 0 32 3 33 7 2 2 2 2 12 0 0 0 0 0 7 2 10 0 0 0 0 8 2 2 2 12 32 3 33 0 0 0 0 0 0 0 0 0 0 0 0 32 3 33 0 8 2 2 2 2 2 2 2 10 0 0 0 0 0 0 1
1 0 0 0 0 0 0 0 0 0 0 32 3 33 7 2 2 2 2 12 0 0 0 0 0 7 2 11 6 6 6 6 9 2 2 2 12 32 3 33 0 0 0 0 0 0 0 0 0 0 0 0 32 3 33 7 9 2 2 2 2 2 2 2 11 12 0 0 0 0 0 1
1 0 0 0 0 0 0 0 0 0 0 32 3 33 7 2 2 2 2 12 0 0 0 0 0 7 2 2 2 2 14 13 13 13 15 2 12 32 3 33 0 0 0 0 0 0 0 0 0 0 0 0 32 3 33 7 2 2 2 2 2 2 2 2 2 12 0 0 0 0 0 1
1 0 0 0 0 0 0 0 0 0 0 32 3 33 7 2 2 2 2 12 0 0 0 0 0 7 2 2 2 2 12 0 0 0 7 2 12 32 3 33 0 0 0 0 0 0 0 0 0 0 0 0 32 3 33 7 2 2 2 2 2 2 2 2 2 12 0 0 0 0 0 1
1 0 0 0 0 0 0 0 0 0 0 32 3 33 7 2 2 2 2 10 0 0 0 0 0 8 2 2 2 2 10 0 0 0 8 2 12 32 3 33 0 0 0 0 0 0 0 0 0 0 0 0 32 3 33 7 2 2 2 2 2 2 2 2 14 0 0 0 0 0 0 1
1 0 0 0 0 0 0 0 0 0 0 32 3 33 7 2 2 2 2 11 6 6 6 6 6 9 2 2 2 2 11 6 6 6 9 2 12 32 3 33 0 0 0 0 0 0 0 0 0 0 0 0 32 3 33 0 15 2 2 2 2 2 2 2 12 0 0 0 0 0 0 1
1 0 0 0 0 0 0 0 0 0 0 32 3 33 7 2 2 14 13 13 13 13 13 13 13 13 13 13 13 13 15 2 2 2 2 2 12 32 3 33 0 0 0 0 0 0 0 0 0 0 0 46 3 3 47 0 7 2 2 2 2 2 2 2 12 0 0 0 0 0 0 1
1 0 0 0 0 0 0 0 0 0 0 32 3 33 7 2 2 12 0 0 0 0 0 0 0 0 0 0 0 0 7 2 2 2 2 2 12 32 3 33 0 0 0 0 0 0 0 0 0 0 46 3 3 47 0 0 8 2 2 2 2 10 0 0 0 0 0 0 0 0 0 1
1 0 0 0 0 0 0 0 0 0 0 32 3 33 7 2 2 10 0 0 0 0 0 0 0 0 0 0 0 0 8 2 2 2 2 2 12 32 3 33 0 0 0 0 0 0 0 0 0 46 3 3 47 0 0 8 9 2 2 2 2 11 12 0 0 0 0 0 0 0 0 1
1 0 0 0 0 0 0 0 0 0 0 32 3 33 7 2 2 11 6 6 6 6 6 6 6 6 6 6 6 6 9 2 2 2 2 2 12 32 3 33 0 0 0 0 0 0 0 0 46 3 3 47 0 8 6 9 2 2 2 2 2 2 10 0 0 0 0 0 0 0 0 1
1 0 0 0 0 0 0 0 0 0 0 32 3 33 0 13 13 13 13 13 13 13 13 13 13 13 13 13 13 13 13 13 13 13 13 13 0 32 3 33 0 0 0 0 0 0 0 46 3 3 47 0 7 9 2 2 2 2 2 2 2 2 11 12 0 0 0 0 0 0 46 1
1 0 0 0 0 0 0 0 0 0 0 32 3 3 44 44 44 44 44 44 44 44 44 44 44 44 44 44 44 44 44 44 44 44 44 44 44 3 3 33 0 0 0 0 0 0 0 32 3 33 0 0 8 26 26 26 26 26 26 26 26 26 26 10 0 0 0 0 0 46 3 1
1 0 0 0 0 0 0 0 0 0 0 32 3 3 3 3 3 3 3 3 3 3 3 3 3 3 3 3 3 3 3 3 3 3 3 3 3 3 3 33 0 0 0 0 0 0 0 32 3 3 24 29 27 27 27 27 27 27 27 27 27 27 27 27 0 46 3 3 3 3 3 1
1 0 0 0 0 0 0 0 0 0 0 32 3 3 3 3 3 3 3 3 3 3 3 3 3 3 3 3 3 3 3 3 3 3 3 3 3 3 3 3 24 0 0 0 0 0 46 3 3 3 3 30 28 28 28 28 28 28 28 28 28 28 28 28 46 3 3 3 3 3 3 1
1 0 0 0 0 0 0 0 0 0 0 32 3 3 3 3 3 3 3 3 3 3 3 3 3 3 3 3 3 3 3 3 3 3 3 3 3 3 3 3 3 44 44 44 44 44 3 3 3 3 3 31 35 35 35 35 35 35 35 35 35 35 35 35 34 3 45 45 45 45 45 1
1 0 0 0 0 0 0 0 0 0 0 32 3 3 3 3 3 3 3 3 3 3 3 3 3 3 3 3 3 3 3 3 3 3 3 3 3 3 3 3 3 3 3 3 3 3 3 3 3 3 3 31 35 35 35 35 35 35 35 35 35 35 35 35 34 47 0 0 0 0 0 1
1 41 0 0 0 0 0 0 0 0 0 32 3 3 3 3 3 3 3 3 3 3 3 3 3 3 3 3 3 3 3 3 3 3 3 3 3 3 3 3 3 3 3 3 3 3 3 3 3 3 3 27 27 27 27 27 27 27 27 27 27 27 27 27 27 44 44 44 44 44 44 1
1 4 41 0 0 0 0 0 0 0 0 32 3 3 3 3 3 3 3 3 3 3 3 3 3 3 3 3 3 3 3 3 3 3 3 3 3 3 3 3 3 3 3 3 3 3 3 3 3 45 47 42 28 28 28 28 28 28 28 28 28 28 28 28 41 25 45 45 45 45 45 1
1 4 4 41 0 0 0 0 0 0 0 25 3 3 3 3 3 3 3 3 3 3 3 3 3 3 3 3 3 3 3 3 3 3 3 3 3 3 3 45 45 45 45 45 45 45 45 45 47 43 42 4 4 2 2 2 2 2 2 2 2 2 2 2 4 4 4 4 41 0 0 1
1 4 4 4 41 0 0 0 0 0 0 0 25 45 45 45 45 45 45 45 45 45 45 45 45 45 45 45 45 45 45 45 45 45 45 45 45 45 47 43 43 43 43 43 43 43 43 43 42 4 4 4 4 2 2 2 2 2 2 2 2 2 2 2 4 4 4 4 4 41 43 1
1 4 4 4 4 12 0 0 0 0 0 0 0 0 0 0 0 0 0 0 0 0 0 0 0 0 0 0 0 0 0 0 0 0 0 0 0 0 42 4 4 4 4 4 4 4 4 4 4 4 4 4 4 2 2 2 2 2 2 2 2 2 2 2 2 4 4 4 4 4 4 1
1 4 4 4 4 12 0 0 0 0 0 0 0 0 0 0 0 0 0 0 0 0 0 0 0 0 0 0 0 0 0 0 0 0 0 0 0 42 4 4 4 4 4 4 4 4 4 4 4 4 4 4 40 2 2 2 2 2 2 2 2 2 2 2 2 4 4 4 4 4 4 1
1 4 4 4 4 12 0 0 0 0 0 0 0 0 0 0 0 0 0 0 0 0 0 0 0 0 0 0 0 0 0 0 0 0 0 0 42 4 4 4 4 4 4 4 4 4 4 4 4 4 4 40 2 2 2 2 2 2 2 2 2 2 2 2 4 4 4 4 4 4 4 1
1 39 4 4 4 12 0 0 0 0 0 0 0 0 0 0 0 0 0 0 0 0 0 0 0 0 0 0 0 0 0 0 0 0 0 42 4 4 4 4 4 4 4 4 4 4 4 4 4 4 40 2 2 2 2 2 2 2 2 2 2 2 2 2 2 38 38 4 4 4 4 1
1 2 39 38 4 12 0 0 0 0 0 0 0 0 0 0 0 0 0 0 0 0 0 0 0 0 0 0 0 0 0 0 0 0 42 4 4 4 4 4 38 38 38 38 38 38 38 38 38 40 2 2 2 2 2 2 2 2 2 2 2 2 2 2 2 2 2 39 38 38 38 1
1 2 2 2 39 12 0 0 0 0 0 0 0 0 0 0 0 0 0 0 0 0 0 0 0 0 0 0 0 0 0 0 0 7 38 38 38 38 38 40 2 2 2 2 2 2 2 2 2 2 2 2 2 2 2 2 2 2 2 2 2 2 2 2 2 2 2 2 2 2 2 1
1 2 2 2 2 10 0 0 0 0 0 0 0 0 0 0 0 0 0 0 0 0 0 0 0 0 0 0 0 0 0 0 0 8 2 2 2 2 2 2 2 2 2 2 2 2 2 2 2 2 2 2 2 2 2 2 2 2 2 2 2 2 2 2 2 2 2 2 2 2 2 1
1 1 1 1 1 1 1 1 1 1 1 1 1 1 1 1 1 1 1 1 1 1 1 1 1 1 1 1 1 1 1 1 1 1 1 1 1 1 1 1 1 1 1 1 1 1 1 1 1 1 1 1 1 1 1 1 1 1 1 1 1 1 1 1 1 1 1 1 1 1 1 1
